┏━━━┳━━━┓
┃■ ◈┃  ◇┃
┃      ━┫
┃    ▣ ◆┃
┃  ━┓   ┃
┃  ◎┃  ▲┃
┃       ┃
┃◉┃    ◩┃
┗━┻━━━━━┛
