┏━━━━━┳━━━━━━━━━┓
┃     ┃      ▣  ┃
┃     ┃         ┃
┃   ┃ ┃         ┃
┃   ┃ ┗━   ━    ┃
┃   ┃■          ┃
┣━  ┗━┓         ┃
┃     ┃         ┃
┃  ━  ┗━        ┃
┃               ┃
┃        ━━━    ┃
┃        ◎    ┃ ┃
┃             ┃ ┃
┃   ┃       ┃ ┃ ┃
┃               ┃
┃     ┃ ┃       ┃
┗━━━━━┻━┻━━━━━━━┛
