┏━━━━━┳━━━━━━━━━┓
┃     ┃      ▣ ▲┃
┃     ┃         ┃
┃   ┃ ┃         ┃
┃   ┃ ┗━   ━    ┃
┃   ┃■          ┃
┣━  ┗━┓         ┃
┃     ┃         ┃
┃  ━  ┗━        ┃
┃               ┃
┃        ━━━    ┃
┃        ◎    ┃◆┃
┃             ┃ ┃
┃   ┃       ┃ ┃ ┃
┃               ┃
┃     ┃ ┃       ┃
┗━━━━━┻━┻━━━━━━━┛
