┏━━━┳━━━┓
┃   ┃   ┃
┃      ━┫
┃    ▣  ┃
┃  ━┓   ┃
┃  ◎┃   ┃
┃       ┃
┃ ┃     ┃
┗━┻━━━━━┛
