┏━━━━━━━━━━━━━━━━━━━━━━━━━━━━━┳━┓
┃                             ┃ ┃
┃        ━           ━━━     ━┫ ┃
┃           ┃   ┃         ┃   ┃ ┃
┃  ━                 ━┓  ━┫  ━┛ ┃
┃                     ┃   ┃     ┃
┃  ━                     ━┛     ┃
┃       ┃■                      ┃
┃       ┗━━━   ━━━              ┃
┃     ┃                         ┃
┃     ┃    ━               ━    ┃
┃   ┃ ┃          ◆┃ ┃           ┃
┃  ━┛             ┗━┫   ┏━   ━━━┫
┃         ┃ ┃       ┃   ┃      ▲┃
┃                               ┃
┃                           ┃   ┃
┃   ┏━                         ━┫
┃   ┃     ┃         ┃           ┃
┃              ━━━┓            ━┫
┃       ┃         ┃             ┃
┃    ━┓   ┏━┓            ━      ┃
┃     ┃   ┃ ┃         ┃    ▣    ┃
┃  ━┳━┻━                        ┃
┃   ┃         ┃ ┃           ┃   ┃
┣━┳━┻━     ━    ┗━┓    ━        ┃
┃◎┃               ┃           ┃ ┃
┃      ━   ━      ┃    ━━━      ┃
┃                 ┃             ┃
┃  ━     ━┓                     ┃
┃         ┃               ┃     ┃
┃                               ┃
┃                               ┃
┗━━━━━━━━━━━━━━━━━━━━━━━━━━━━━━━┛
