┏━━━━━┳━━━━━━━━━┓
┃◇    ┃      ▣ ▲┃
┃     ┃         ┃
┃◈  ┃ ┃         ┃
┃   ┃ ┗━   ━    ┃
┃◉  ┃■          ┃
┣━  ┗━┓         ┃
┃     ┃         ┃
┃  ━  ┗━        ┃
┃               ┃
┃        ━━━    ┃
┃        ◎    ┃◆┃
┃             ┃ ┃
┃   ┃◩      ┃ ┃ ┃
┃               ┃
┃     ┃ ┃       ┃
┗━━━━━┻━┻━━━━━━━┛
