┏━━━┳━━━┓
┃■  ┃   ┃
┃      ━┫
┃    ▣ ◆┃
┃  ━┓   ┃
┃  ◎┃  ▲┃
┃       ┃
┃ ┃     ┃
┗━┻━━━━━┛
